    299 (<|>)	Text.ParserCombinators.Parsec
    224 eof	Text.ParserCombinators.Parsec
    208 GenParser	Text.ParserCombinators.Parsec
    180 char	Text.ParserCombinators.Parsec
    179 many1	Text.ParserCombinators.Parsec
    168 many	Text.ParserCombinators.Parsec
    162 manyTill	Text.ParserCombinators.Parsec
    157 try	Text.ParserCombinators.Parsec
    155 runParser	Text.ParserCombinators.Parsec
    147 parse	Text.ParserCombinators.Parsec
    140 getState	Text.ParserCombinators.Parsec
    132 newline	Text.ParserCombinators.Parsec
    125 lookAhead	Text.ParserCombinators.Parsec
    124 updateState	Text.ParserCombinators.Parsec
    123 string	Text.ParserCombinators.Parsec
    121 setState	Text.ParserCombinators.Parsec
    113 Parser	Text.ParserCombinators.Parsec
    107 oneOf	Text.ParserCombinators.Parsec
    103 digit	Text.ParserCombinators.Parsec
     97 (<?>)	Text.ParserCombinators.Parsec
     90 option	Text.ParserCombinators.Parsec
     80 noneOf	Text.ParserCombinators.Parsec
     77 anyChar	Text.ParserCombinators.Parsec
     73 pzero	Text.ParserCombinators.Parsec
     68 choice	Text.ParserCombinators.Parsec
     67 between	Text.ParserCombinators.Parsec
     64 sepBy	Text.ParserCombinators.Parsec
     60 satisfy	Text.ParserCombinators.Parsec
     52 ParseError	Text.ParserCombinators.Parsec
     52 CharParser	Text.ParserCombinators.Parsec
     50 sepBy1	Text.ParserCombinators.Parsec
     48 letter	Text.ParserCombinators.Parsec
     47 alphaNum	Text.ParserCombinators.Parsec
     43 spaces	Text.ParserCombinators.Parsec
     42 notFollowedBy	Text.ParserCombinators.Parsec
     41 skipMany	Text.ParserCombinators.Parsec
     40 space	Text.ParserCombinators.Parsec
     39 getPosition	Text.ParserCombinators.Parsec
     35 makeTokenParser	Text.ParserCombinators.Parsec.Token
     34 optional	Text.ParserCombinators.Parsec
     34 count	Text.ParserCombinators.Parsec
     33 optionMaybe	Text.ParserCombinators.Parsec
     32 SourcePos	Text.ParserCombinators.Parsec
     31 unexpected	Text.ParserCombinators.Parsec
     28 hexDigit	Text.ParserCombinators.Parsec
     28 getInput	Text.ParserCombinators.Parsec
     26 whiteSpace	Text.ParserCombinators.Parsec.Token
     25 symbol	Text.ParserCombinators.Parsec.Token
     25 sepEndBy	Text.ParserCombinators.Parsec
     25 many1	Text.Parsec
     24 try	Text.Parsec
     24 identifier	Text.ParserCombinators.Parsec.Token
     24 char	Text.Parsec
     23 reserved	Text.ParserCombinators.Parsec.Token
     23 parseFromFile	Text.ParserCombinators.Parsec
     22 sourceColumn	Text.ParserCombinators.Parsec
     22 parse	Text.Parsec
     22 parens	Text.ParserCombinators.Parsec.Token
     22 eof	Text.Parsec
     20 string	Text.Parsec
     20 sourceLine	Text.ParserCombinators.Parsec
     20 skipMany1	Text.ParserCombinators.Parsec
     20 sepEndBy1	Text.ParserCombinators.Parsec
     19 sourceName	Text.ParserCombinators.Parsec
     19 lexeme	Text.ParserCombinators.Parsec.Token
     18 upper	Text.ParserCombinators.Parsec
     18 token	Text.ParserCombinators.Parsec
     18 ParsecT	Text.Parsec
     18 comma	Text.ParserCombinators.Parsec.Token
     17 SourceName	Text.ParserCombinators.Parsec
     17 semi	Text.ParserCombinators.Parsec.Token
     17 lower	Text.ParserCombinators.Parsec
     16 (<|>)	Text.Parsec
     16 setPosition	Text.ParserCombinators.Parsec
     16 digit	Text.Parsec
     15 reservedOp	Text.ParserCombinators.Parsec.Token
     15 natural	Text.ParserCombinators.Parsec.Token
     14 setInput	Text.ParserCombinators.Parsec
     14 braces	Text.ParserCombinators.Parsec.Token
     13 ParseError	Text.Parsec
     13 manyTill	Text.Parsec
     12 (<?>)	Text.Parsec
     12 anyChar	Text.Parsec
     11 tokenPrim	Text.ParserCombinators.Parsec
     11 stringLiteral	Text.ParserCombinators.Parsec.Token
     11 setSourceLine	Text.ParserCombinators.Parsec
     11 option	Text.Parsec
     11 octDigit	Text.ParserCombinators.Parsec
     11 endBy	Text.ParserCombinators.Parsec
     11 choice	Text.Parsec
     10 spaces	Text.Parsec
     10 oneOf	Text.Parsec
     10 many	Text.Parsec
      9 Stream	Text.Parsec
      9 space	Text.Parsec
      9 parseTest	Text.ParserCombinators.Parsec
      9 optionMaybe	Text.Parsec
      9 noneOf	Text.Parsec
      9 getParserState	Text.ParserCombinators.Parsec
      9 float	Text.ParserCombinators.Parsec.Token
      9 commaSep	Text.ParserCombinators.Parsec.Token
      8 tab	Text.ParserCombinators.Parsec
      8 setSourceColumn	Text.ParserCombinators.Parsec
      8 setParserState	Text.ParserCombinators.Parsec
      8 operator	Text.ParserCombinators.Parsec.Token
      8 Line	Text.ParserCombinators.Parsec
      8 integer	Text.ParserCombinators.Parsec.Token
      8 incSourceColumn	Text.ParserCombinators.Parsec
      8 errorPos	Text.ParserCombinators.Parsec
      8 charLiteral	Text.ParserCombinators.Parsec.Token
      8 chainr1	Text.ParserCombinators.Parsec
      8 chainl1	Text.ParserCombinators.Parsec
      8 brackets	Text.ParserCombinators.Parsec.Token
      8 anyToken	Text.ParserCombinators.Parsec
      8 alphaNum	Text.Parsec
      7 SourceName	Text.Parsec
      7 sepEndBy1	Text.Parsec
      7 sepBy	Text.Parsec
      7 optional	Text.Parsec
      7 notFollowedBy	Text.Parsec
      7 newline	Text.Parsec
      7 makeTokenParser	Text.Parsec.Token
      7 Column	Text.ParserCombinators.Parsec
      7 colon	Text.ParserCombinators.Parsec.Token
      6 whiteSpace	Text.Parsec.Token
      6 tokenPrimEx	Text.ParserCombinators.Parsec
      6 Stream(..)	Text.Parsec
      6 setSourceName	Text.ParserCombinators.Parsec
      6 letter	Text.Parsec
      6 label	Text.ParserCombinators.Parsec
      6 labels	Text.ParserCombinators.Parsec
      6 incSourceLine	Text.ParserCombinators.Parsec
      6 identifier	Text.Parsec.Token
      6 getInput	Text.Parsec
      6 decimal	Text.ParserCombinators.Parsec.Token
      6 between	Text.Parsec
      5 tokens	Text.ParserCombinators.Parsec
      5 State(..)	Text.ParserCombinators.Parsec
      5 sourceLine	Text.Parsec
      5 sepBy1	Text.Parsec
      5 runParserT	Text.Parsec
      5 reservedOp	Text.Parsec.Token
      5 reservedOpNames	Text.ParserCombinators.Parsec.Token
      5 reservedNames	Text.ParserCombinators.Parsec.Token
      5 Parsec	Text.Parsec
      5 integer	Text.Parsec.Token
      5 getPosition	Text.Parsec
      5 endBy1	Text.ParserCombinators.Parsec
      5 chainr	Text.ParserCombinators.Parsec
      5 chainl	Text.ParserCombinators.Parsec
      4 TokenParser	Text.ParserCombinators.Parsec.Token
      4 SourcePos	Text.Parsec
      4 sourceName	Text.Parsec
      4 sourceColumn	Text.Parsec
      4 setSourceLine	Text.Parsec
      4 setInput	Text.Parsec
      4 satisfy	Text.Parsec
      4 runParser	Text.Parsec
      4 runParsecT	Text.Parsec
      4 reserved	Text.Parsec.Token
      4 Reply(..)	Text.Parsec
      4 parserZero	Text.Parsec
      4 parserFail	Text.Parsec
      4 parens	Text.Parsec.Token
      4 lookAhead	Text.Parsec
      4 identLetter	Text.ParserCombinators.Parsec.Token
      4 dot	Text.ParserCombinators.Parsec.Token
      4 Consumed(..)	Text.Parsec
      4 commentLine	Text.ParserCombinators.Parsec.Token
      4 comma	Text.Parsec.Token
      4 braces	Text.Parsec.Token
      3 upper	Text.Parsec
      3 unknownError	Text.Parsec
      3 tokenPrim	Text.Parsec
      3 ..	Text.ParserCombinators.Parsec.Token
      3 symbol	Text.Parsec.Token
      3 stringLiteral	Text.Parsec.Token
      3 skipMany	Text.Parsec
      3 skipMany1	Text.Parsec
      3 setSourceName	Text.Parsec
      3 setSourceColumn	Text.Parsec
      3 setPosition	Text.Parsec
      3 reservedOpNames	Text.Parsec.Token
      3 reservedNames	Text.Parsec.Token
      3 opLetter	Text.ParserCombinators.Parsec.Token
      3 natural	Text.Parsec.Token
      3 naturalOrFloat	Text.ParserCombinators.Parsec.Token
      3 mkPT	Text.Parsec
      3 lexeme	Text.Parsec.Token
      3 identStart	Text.Parsec.Token
      3 hexDigit	Text.Parsec
      3 hexadecimal	Text.ParserCombinators.Parsec.Token
      3 float	Text.Parsec.Token
      3 endBy	Text.Parsec
      3 count	Text.Parsec
      3 commaSep1	Text.ParserCombinators.Parsec.Token
      3 caseSensitive	Text.ParserCombinators.Parsec.Token
      3 brackets	Text.Parsec.Token
      3 angles	Text.ParserCombinators.Parsec.Token
      3 angles	Text.Parsec.Token
      2 updateState	Text.Parsec
      2 updateParserState	Text.Parsec
      2 unexpected	Text.Parsec
      2 token	Text.Parsec
      2 tokens	Text.Parsec
      2 tokenPrimEx	Text.Parsec
      2 TokenParser	Text.Parsec.Token
      2 ..	Text.Parsec.Token
      2 tab	Text.Parsec
      2 sysUnExpectError	Text.Parsec
      2 State(..)	Text.Parsec
      2 squares	Text.ParserCombinators.Parsec.Token
      2 setState	Text.Parsec
      2 setParserState	Text.Parsec
      2 sepEndBy	Text.Parsec
      2 semi	Text.Parsec.Token
      2 runPT	Text.Parsec
      2 runP	Text.Parsec
      2 putState	Text.Parsec
      2 parseTest	Text.Parsec
      2 parserReturn	Text.Parsec
      2 parserPlus	Text.Parsec
      2 parserBind	Text.Parsec
      2 parsecMap	Text.Parsec
      2 opStart	Text.ParserCombinators.Parsec.Token
      2 octDigit	Text.Parsec
      2 octal	Text.ParserCombinators.Parsec.Token
      2 nestedComments	Text.ParserCombinators.Parsec.Token
      2 naturalOrFloat	Text.Parsec.Token
      2 modifyState	Text.Parsec
      2 mergeErrorReply	Text.Parsec
      2 manyAccum	Text.Parsec
      2 lower	Text.Parsec
      2 Line	Text.Parsec
      2 label	Text.Parsec
      2 labels	Text.Parsec
      2 incSourceLine	Text.Parsec
      2 incSourceColumn	Text.Parsec
      2 identStart	Text.ParserCombinators.Parsec.Token
      2 getState	Text.Parsec
      2 getParserState	Text.Parsec
      2 errorPos	Text.Parsec
      2 endBy1	Text.Parsec
      2 commentStart	Text.ParserCombinators.Parsec.Token
      2 commentEnd	Text.ParserCombinators.Parsec.Token
      2 Column	Text.Parsec
      2 colon	Text.Parsec.Token
      2 chainr	Text.Parsec
      2 chainr1	Text.Parsec
      2 chainl	Text.Parsec
      2 chainl1	Text.Parsec
      2 anyToken	Text.Parsec
      1 stateUser)	Text.ParserCombinators.Parsec
      1 State(State)	Text.Parsec
      1 State(statePos)	Text.ParserCombinators.Parsec
      1 State(stateInput	Text.ParserCombinators.Parsec
      1 State(stateInput)	Text.Parsec
      1 statePos	Text.ParserCombinators.Parsec
      1 squares	Text.Parsec.Token
      1 semiSep	Text.Parsec.Token
      1 semiSep1	Text.ParserCombinators.Parsec.Token
      1 semiSep1	Text.Parsec.Token
      1 opStart	Text.Parsec.Token
      1 opLetter	Text.Parsec.Token
      1 operator	Text.Parsec.Token
      1 octal	Text.Parsec.Token
      1 nestedComments	Text.Parsec.Token
      1 LanguageDef	Text.ParserCombinators.Parsec.Token
      1 identLetter	Text.Parsec.Token
      1 hexadecimal	Text.Parsec.Token
      1 dot	Text.Parsec.Token
      1 decimal	Text.Parsec.Token
      1 commentStart	Text.Parsec.Token
      1 commentLine	Text.Parsec.Token
      1 commentEnd	Text.Parsec.Token
      1 commaSep	Text.Parsec.Token
      1 commaSep1	Text.Parsec.Token
      1 charLiteral	Text.Parsec.Token
      1 caseSensitive	Text.Parsec.Token
